################################################################################################################################
#                                                                                                                              #
#                                                               ###########                                                    #
#                                                               #.........#                                                    #
#                                                               #.........#                                                    #
#                                                             ###.........#####                                                #
#                                    ##########################.#.........#...#                                            #####
#                                    #........................#.#.........#...#                                            #...#
#                                    #........................#.#.........#...#                                            #...#
#                                    #........................#.#.........#...#                                            #...#
#                                    #........................#.#.........#...#                                            #...#
#                                    #........................#.#.........#...#                                            #####
#                                    #........................#.#.........#...#                                            #...#
#                                    #........................#.#.........#...#                                            #...#
#                                    #........................#.#.........#...#                                            #####
#                                    #........................#########################                                        #
#                                    #........................#.......................#                        #################
#           ##########################........................#.......................#                        #...............#
#           #........................#........................#.......................#                        #...............#
#           #........................#........................#########################                        #...............#
#           #........................#........................#...............#                                #...............#
#           #........................#........................#...............#                                #...............#
#           #........................#........................#...............#                                #...............#
#           #........................#........................#...............#                                #...............#
#           #........................#........................#...............#                                #...............#
#           #........................#........................#...............#                                #...............#
#           #........................#........................#...............#                                #...............#
#           #........................#........................#...............#                                #...............#
#           ##########################........................#...............#                                #...............#
#                                    #........................#...............#    #######                     #...............#
#                                 ####........................#...............#    #.....#                     #...............#
#                                 #..#........................#...............#    #.....#                     #################
#                            ######..#........................#...............#    #.....#                                     #
#                            #....#..#........................#################    #.....#                                     #
#                            #....#..##########################                    #.....#                                     #
#                            #....#............#                                   #.....#                                     #
#                            #....#............#                                   #.....#                                     #
#                            #....#............#                   #################.....####                                  #
#                         #########............#                   #...............#.....#..#                                  #
#                         #......##............#                   #...............#.....#..#                                  #
#                         #......##............#                   #...............#.....#..#                                  #
#                 #########################....#                   #...........########..#..#                                  #
#                 #.......................#....#                   #...........#......#..#..#                                  #
#                 #.......................#....#                   #...........#......#..#..#                                  #
#                 #.......................#....#                   #...........#......##############                           #
#                 #.......................#....#                   #...........#......#............#                           #
#                 #.......................#....#                   #...........#......#............#               #########   #
#                 #########################....#                   #############......#............#               #.......#   #
#                         #......##............#                            ####......#............#####           #.......#   #
#                         #......##............#               ############ #..#......#............#...#           #.......#   #
#                         #......##............#               #..........# #..########............#...#           #.......#   #
#                         #########............#               #..........# #..#...................#...#           #.......#   #
#                                 #............#####           #..........# #..#...................#...#           #.......#   #
#                                 #............#...#           ############ ####...................#####           #.......#   #
#                                 ##############...#                           #...................#               #.......#   #
#                                       #..........#                           #...................#               #.......#   #
#                                       #..........#                           #...................#               #.......#   #
#                                       ############                           #...................#               #.......#   #
#                                                                              #...................#               #.......#   #
#                                                                              #...................#               #.......#   #
#                                                                              #...................#               #.......#   #
#                                                                              #...................#               #.......#   #
#                                                                              #...................#               #.......#   #
################################################################################################################################
